1111111111
1000010001
1000010001
1000000001
1000010001
1101110001
1100110001
1110110001
1100010001
1000011111
1000000001
1000001001
1111111111
