111111111111111111111111111111
111111111111000000011110000001
100011110011000000011111110001
100011100011000000000000000001
100011100111000000000000000001
100000000111000000011111111001
100000000111000000011110000001
100111111111100111000110000001
100111111111100111110110011111
100111111111100000000110011111
100000011000000000000110000001
100000000000000000000110000001
111111000011100000000110000001
111111110010100000000110000001
100111110010100000000111111011
100000000010111110111000011011
100000000010000000000011000011
111111111111111111111111111111